11111111111
100P0C0E011
10000000011
11111111111
